1 1 1 10 11 1 1 1 1 1
5 5 5 12 13 5 5 5 5 5  
17 17 17 17 17 17 15 15 15 15 
0 0 0 0 17 17 15 15 15 15 
0 0 0 0 17 17 15 15 15 15 
17 17 17 17 17 17 15 15 15 15 