1 10 11 1 1 1 1 10 11 1 
5 12 13 5 5 5 5 12 13 5 
17 17 17 17 17 17 17 17 17 17 
17 17 17 0 0 0 0 17 17 17 
17 17 17 0 0 0 0 17 17 17 
17 17 17 17 17 17 17 17 17 17