1 1 1 3 2 3 2 1 1 1
5 5 5 7 6 7 6 5 5 5
0 0 0 0 0 0 0 0 0 0
0 0 0 0 0 0 0 0 0 0
0 0 0 0 0 0 0 0 0 0
0 0 0 0 0 0 0 0 0 0