1 1 1 1 1 1 1 5 5 1 1 1 1 1 1 1
1 7 0 0 0 1 1 5 5 1 1 7 0 0 0 1
1 0 0 0 0 1 1 5 5 1 1 0 0 0 0 1
1 0 0 0 0 1 1 5 5 1 1 0 0 0 0 1
1 1 1 1 1 1 1 5 5 1 1 1 1 1 1 1
5 5 5 5 5 5 5 6 6 5 5 5 5 5 5 5 
5 5 5 5 5 5 5 6 6 5 5 5 5 5 5 5
1 1 1 1 1 1 1 5 5 1 1 1 1 1 1 1
1 7 0 0 0 1 1 5 5 1 1 7 0 0 0 1
1 0 0 0 0 1 1 5 5 1 1 0 0 0 0 1
1 0 0 0 0 1 1 5 5 1 1 0 0 0 0 1
1 1 1 1 1 1 1 5 5 1 1 1 1 1 1 1