3 2 1 3 2 3 2 1 3 2
7 6 5 7 6 7 6 5 7 6
17 17 17 17 17 17 17 17 17 17
0 0 0 0 0 0 0 0 0 0 
0 0 0 0 0 0 0 0 0 0 
0 0 0 0 0 0 0 0 0 0 