2 2 4 4 4 4 0 0 0 0 0 0 0 1 1 0 0 0 6 6 5 5 5 5 5 5 5 5 6 6 0 0 0 0 0 0 0 0 0 0 1 1 0 0 0 0 4 0
4 2 2 4 4 4 0 0 1 1 0 0 0 0 0 0 0 0 6 6 6 5 5 5 5 5 5 6 6 6 0 0 0 0 0 0 0 0 0 0 1 1 0 0 0 0 0 4
4 2 2 4 4 4 0 0 0 0 1 1 0 0 0 0 0 0 0 0 6 6 5 5 5 5 6 6 0 0 0 0 0 0 0 0 0 0 0 0 1 1 0 4 4 4 4 4
4 4 4 4 4 4 0 0 0 0 0 0 0 0 0 0 0 0 0 0 0 6 5 5 5 5 6 0 0 0 0 0 0 0 0 0 0 0 0 0 1 1 4 0 4 4 4 4
4 4 4 4 4 4 0 0 0 0 0 0 0 0 0 0 0 0 0 0 0 0 6 5 5 6 0 0 0 0 0 0 0 0 0 0 0 0 0 0 1 1 0 0 0 0 4 4
0 0 0 0 0 0 0 0 1 0 0 0 0 0 0 0 0 0 0 0 0 0 6 5 5 6 0 0 0 0 0 0 0 0 0 0 0 0 0 0 1 1 0 0 4 0 4 4
0 1 0 0 0 0 1 0 0 0 0 0 1 0 0 0 0 0 0 0 0 0 6 5 5 6 0 0 0 0 0 0 0 0 0 0 0 0 0 0 1 1 0 4 0 0 0 0
0 0 0 1 1 0 0 0 0 1 0 0 0 0 0 0 0 0 0 0 0 0 6 5 5 6 0 0 0 0 0 0 0 0 0 0 0 0 0 0 0 0 0 0 4 0 0 0
0 0 0 1 1 0 0 0 0 0 0 0 0 0 0 0 0 0 0 0 0 0 6 5 5 6 0 0 0 0 0 0 0 0 0 0 0 0 0 0 0 0 0 4 0 0 0 0
0 0 0 0 0 0 0 0 0 0 0 0 0 0 0 0 0 0 0 0 0 0 6 5 5 6 0 0 0 0 0 0 0 0 0 0 0 0 0 0 0 0 4 4 0 0 1 1             
0 0 0 0 0 0 0 1 0 0 0 0 0 0 0 0 0 0 0 0 0 0 6 5 5 6 0 0 0 0 0 0 0 0 0 0 0 0 0 0 0 0 4 4 1 1 0 0
0 0 0 0 0 0 0 0 0 0 0 0 0 0 0 0 0 0 0 0 0 0 6 5 5 6 0 0 0 0 0 0 0 0 0 0 0 0 0 0 0 0 4 4 0 0 0 0
0 0 0 0 0 0 0 0 0 0 0 0 0 0 0 0 0 0 0 0 0 0 0 5 5 0 0 0 0 0 0 0 1 1 1 1 1 1 1 1 1 1 4 4 4 4 4 4
0 0 0 0 0 0 0 0 0 0 0 0 0 0 0 0 0 0 0 0 0 0 0 5 5 0 0 0 0 0 0 0 1 1 1 1 1 1 1 1 1 1 4 1 1 1 1 4
0 0 0 0 0 0 0 0 0 0 0 0 0 0 0 0 0 0 0 0 0 0 0 5 5 0 0 0 0 0 0 0 1 1 1 1 1 1 1 1 1 1 4 1 1 1 1 4
0 0 0 0 0 0 0 0 0 0 0 0 0 0 0 0 0 0 0 0 0 0 0 5 5 0 0 0 0 0 0 0 1 1 1 1 1 1 1 1 1 1 4 1 1 1 1 4
0 0 0 0 6 6 6 6 0 0 0 0 0 0 0 0 0 0 0 0 0 0 0 5 5 0 0 0 0 0 0 0 1 1 1 1 1 1 1 1 1 1 4 4 4 4 4 4
0 0 0 0 6 6 6 6 6 5 5 5 5 5 5 5 5 5 5 5 5 5 5 6 6 5 5 5 5 5 5 5 5 5 5 5 5 5 5 5 5 5 5 5 5 5 4 4 
0 0 0 0 6 6 6 6 6 5 5 5 5 5 5 5 5 5 5 5 5 5 5 6 6 5 5 5 5 5 5 5 5 5 5 5 5 5 5 5 5 5 5 5 5 5 4 4 
0 0 0 0 6 6 6 6 0 0 0 0 0 0 0 0 0 0 0 0 0 0 0 5 5 0 0 0 0 0 0 0 1 1 1 1 1 5 5 1 1 1 4 4 4 4 4 4
0 0 0 0 0 0 0 0 0 0 0 0 0 0 0 0 0 0 0 0 0 0 0 5 5 0 0 0 0 0 0 0 1 1 1 1 1 5 5 1 1 1 4 1 1 1 1 4
0 0 0 0 0 0 0 0 0 0 0 0 0 0 0 0 0 0 0 0 0 0 0 5 5 0 0 0 0 0 0 0 1 1 1 1 1 5 5 1 1 1 4 1 1 1 1 4
0 0 0 0 0 0 0 0 0 0 0 0 0 0 0 0 0 0 0 0 0 0 0 5 5 0 0 0 0 0 0 0 1 1 1 1 1 5 5 1 1 1 4 1 1 1 1 4
0 0 0 0 0 0 0 0 0 0 0 0 0 0 0 0 0 0 0 0 0 0 0 5 5 0 0 0 0 0 0 0 1 1 1 1 1 5 5 1 1 1 4 4 4 4 4 4
0 0 0 0 0 0 0 0 0 0 0 0 0 0 0 0 1 1 1 1 1 1 1 5 5 1 1 1 1 1 1 1 0 0 0 0 0 5 5 0 0 0 0 0 0 0 0 0 
3 0 0 3 3 3 0 0 0 0 0 0 0 0 0 0 1 1 1 1 1 1 1 5 5 1 1 1 1 1 1 1 0 0 0 0 0 5 5 0 0 0 0 0 0 0 0 0
3 3 3 3 3 3 3 3 0 0 0 0 0 0 0 0 1 1 1 1 1 1 1 5 5 1 1 1 1 1 1 1 0 0 0 0 0 5 5 0 0 0 0 0 0 0 0 0
3 3 3 3 3 3 3 3 0 0 0 0 0 0 0 0 1 1 1 1 1 1 1 5 5 1 1 1 1 1 1 1 0 0 0 0 0 5 5 0 0 0 0 0 0 0 0 0
3 3 3 3 3 3 3 3 0 0 0 0 0 0 0 0 1 1 1 1 1 1 1 5 5 1 1 1 1 1 1 1 0 0 0 0 0 5 5 0 0 0 0 0 0 0 0 0
2 2 2 2 2 2 3 3 3 3 3 3 0 0 0 0 1 1 1 1 1 1 1 5 3 1 1 1 1 1 1 1 0 0 0 0 0 0 0 0 0 0 0 0 0 0 0 0
2 2 2 2 2 2 3 3 3 3 3 3 0 0 0 0 1 1 1 1 1 1 1 1 5 1 1 1 1 1 1 1 0 0 0 0 0 1 0 0 0 0 0 0 0 0 0 0
2 2 2 2 2 2 2 3 3 3 3 3 0 0 0 0 1 1 1 1 1 1 1 1 5 3 1 1 1 1 1 1 0 0 0 0 0 1 4 0 0 0 0 0 0 0 4 4
2 2 2 2 2 2 2 2 3 3 3 3 0 0 0 0 1 1 1 1 1 1 1 3 1 1 1 1 1 1 1 1 0 0 0 0 0 4 1 1 0 0 0 0 0 4 4 4
2 2 2 2 2 2 2 2 2 2 2 3 3 0 0 0 1 1 1 1 3 3 3 3 3 3 3 3 1 1 1 1 0 0 0 0 0 4 4 4 4 1 0 0 4 1 1 0
2 2 2 2 2 2 2 2 2 2 2 3 3 0 0 0 1 1 1 3 2 2 2 2 2 2 2 2 3 1 1 1 0 0 0 0 0 0 0 0 4 4 0 0 4 4 1 0
2 2 2 2 2 2 2 2 2 2 2 3 3 3 0 0 1 1 3 3 2 2 2 2 2 2 2 2 3 3 1 1 0 0 0 0 0 0 0 0 0 0 4 4 0 1 0 0


 
 
 
 



































