3 2 1 3 2 3 2 1 3 2 1 10 11 1 1 1 1 10 11 1 1 1 1 10 11 1 1 1 1 1 14 14 14 14 14 14 16 14 14 14
7 6 5 7 6 7 6 5 7 6 5 12 13 5 5 5 5 12 13 5 5 5 5 12 13 5 5 5 5 5 16 16 16 16 16 16 16 14 14 14 
17 17 17 17 17 17 17 17 17 17 17 17 17 17 17 17 17 17 17 17 17 17 17 17 17 17 15 15 15 15 15 15 15 15 15 15 16 14 14 14
0 0 0 0 0 0 0 0 0 0 17 17 17 0 0 0 0 17 17 17 0 0 0 0 17 17 15 15 15 15 15 15 15 15 15 15 16 14 14 14
0 0 0 0 0 0 0 0 0 0 17 17 17 0 0 0 0 17 17 17 0 0 0 0 17 17 15 15 15 15 16 16 16 16 16 16 16 14 14 14
0 0 0 0 0 0 0 0 0 0 17 17 17 17 17 17 17 17 17 17 17 17 17 17 17 17 15 15 15 15 14 14 14 14 14 14 16 14 14 14

